47
1 21 -1 -320 400 5952 32 4
2 43 -1 55 338 0 0 0
3 43 -1 180 273 0 0 0
4 43 -1 310 338 0 0 0
5 43 -1 440 273 0 0 0
6 43 -1 565 338 0 0 0
7 43 -1 700 273 0 0 0
8 43 -1 820 338 0 0 0
9 43 -1 950 273 0 0 0
10 43 -1 1080 338 0 0 0
11 43 -1 1205 273 0 0 0
12 43 -1 1335 148 0 0 0
13 43 -1 1715 148 0 0 0
14 43 -1 1850 338 0 0 0
15 43 -1 1975 148 0 0 0
16 43 -1 2100 338 0 0 0
17 43 -1 2230 338 0 0 0
18 43 -1 2355 338 0 0 0
19 43 -1 2480 338 0 0 0
20 43 -1 2605 338 0 0 0
21 43 -1 2735 268 0 0 0
22 43 -1 2870 148 0 0 0 
23 43 -1 3005 88 0 0 0
24 43 -1 3245 148 0 0 0
25 43 -1 3375 118 0 0 0
26 43 -1 3125 343 0 0 0
27 43 -1 3505 278 0 0 0
28 21 -1 1376 273 96 32 4
29 21 -1 1505 208 320 32 4
30 21 -1 1855 272 160 32 4
31 21 -1 2785 208 544 32 4

33 21 -1 3330 273 128 32 4

34 21 -1 3057 238 32 160 4

44 47 -1 3255 557 0 0 0


54 47 1 1248 397 0 0 0
55 48 1 1377 212 0 0 0
56 47 1 2594 397 0 0 0
57 48 1 2786 148 0 0 0
58 47 -1 3542 395 0 0 0
59 48 -1 3413 210 0 0 0
60 47 1 1441 272 0 0 0
61 48 1 1506 147 0 0 0
62 47 -1 1880 271 0 0 0
63 48 -1 1815 149 0 0 0
64 26 -1 2000 113 0 0 0

65 23 -1 3054 113 0 0 0

93 26 -1 4076 112 0 0 0


// id 124 - kích hoạt boss
 
cầu thang 47 bottom, 48 top
id 45: object ẩn -> trở lên trước khi xuống hồ nước -> tự sinh ra
id 71: Holy Water

id 72: brick -> a bonus

id 39: brick 4 ô -> chỉ effect
id 40: brick 3 ô ->Pot Roast
id 41: object ẩn -> xuống hồ nước
 
id 51: brick 2 -> effect
id 65: object ẩn -> bonus
id 66: object ẩn -> chạm nước -> chết
id 67: object ẩn -> box xác nhận simon đã qua cửa

id 23, 98: cross

// id 81: object ẩn -> ra khỏi hồ nước phía phải
id 86: object ẩn -> vào hồ nước phía phải


// id 64, type 26 Object ẩn dùng để mở cửa 

id 104: Double shot